...G.....CGC........
..G#.....#####......
.G#....H............
.#.....#......GCG...
..............###...
....G...............
...###........G.....
.........G.G..#.....
.........###........
................GC..
....GGG.......GG##..
....###.......###...
...................#
.1.........C....C.X.
####################
