G.G................G
-.-.............#G..
.G.....C.GXGH....#..
.......##--##.......
..G..............G.C
####..G.G.G.G....###
.......GHGCGCG......
......--#---#-......
....................
HG.G............G.G.
####............###.
....#........-......
.......C............
.1.....#..C...C...H.
####################
