G...................
GC.G............X..G
--.-.....G....--#-..
....-....-..........
....................
...G....H.GC...G....
...--..#####...--...
....G...........G...
..........H.H.......
.........----.......
....G...........G...
...--..........--...
.1...............C..
####################
